SSSSSSSSSSSSSSn
RSSSSSSSSSSSSRn
RRSSSSSSSSSSRRn
RRRSSSSSSSSRRRn
RRRRSSSSSSRRRRn
RRRSSSSSSSSRRRn
RRSSSSSSSSSSRRn
RSSSGSSSSGSSSRn
GGGGGGGGGGGGGGn
GGGGGGGGGGGGGGn