WD WD WD WD WD WD WD WD WD WD SS SS SS SS SS SS SS SS SS SS SS SS SS SS SS SS SS SS n
WD WD WD WD WD WD WD WD WD WD SS SS SS SS SS SS SS SS SS SS SS SS SS SS SS SS SS SS n
WL WL WL WL WL WL WL WL WL WD SS SS SS SS SS SS SS SS SS SS SS SS SS SS SS SS SS SS n
WL TS TS TS TS TS TS TS WL WD SS SS SS SS SS SS SS SS SS SS SS SS SS SS SS SS SS SS n
WL TS TS TS TS TS TS TS WL WD SS SS SS SS SS SS SS SS SS SS SS SS SS SS SS SS SS SS n
WL TS TS TS TS TS TS TS WL WD SS SS SS SS SS SS SS SS SS SS SS SS SS SS SS SS SS SS n
WL TS TS TS TS TS TS TS WL WD SS SS SS SS SS SS SS SS SS SS SS SS SS SS SS SS SS SS n
WL TS TS TS TS TS TS TS WO WO WO SS SS SS SS SS SS SS SS SS SS SS SS SS SS SS SS SS n
WL TS TS TS TS TS TS TS WO WO WO SS SS SS SS SS SS SS SS SS SS SS SS SS SS SS SS SS n
WL TS TS TS TS TS TS TS WO WO WO SS SS SS SS SS SS SS SS SS SS SS SS SS SS SS SS SS n
WL TS TS TS TS TS TS TS WO WO WO SS SS SS SS SS SS SS SS SS SS SS SS SS SS SS SS SS n
WL TS TS TS TS TS TS TS WO WO WO SS SS SS SS SS SS SS SS SS SS SS SS SS SS SS SS SS n
WL TS TS TS TS TS TS TS WL WD SS SS SS SS SS SS SS SS SS SS SS SS SS SS SS SS SS SS n
WL TS TS TS TS TS TS TS WL WD SS SS SS SS SS SS SS SS SS SS SS SS SS SS SS SS SS SS n
WL TS TS TS TS TS TS TS WL WD SS SS SS SS SS SS SS SS SS SS SS SS SS SS SS SS SS SS n
WL TS TS TS TS TS TS TS WL WD SS SS SS SS SS SS SS SS SS SS SS SS SS SS SS SS SS SS n
WL TS TS TS TS TS TS TS WL WD SS SS SS SS SS SS SS SS SS SS SS SS SS SS SS SS SS SS n
WL WL WL WL WL WL WL WL WL WD SS SS SS SS SS SS SS SS SS SS SS SS SS SS SS SS SS SS n
WD WD WD WD WD WD WD WD WD WD SS SS SS SS SS SS SS SS SS SS SS SS SS SS SS SS SS SS n
WD WD WD WD WD WD WD WD WD WD SS SS SS SS SS SS SS SS SS SS SS SS SS SS SS SS SS SS n