SSSSSRRRRSSSSSn
RSSSSSRRRSSSSRn
RRSSSSRRRSSSRRn
RRRSSSRRRSSRRRn
RRRRSSRRRSRRRRn
RRRSSSRRRSSRRRn
RRSSSSSSSSSSRRn
RSSSGSSSSGSSSRn
GGGGGGGGGGGGGGn
GGGGGGGGGGGGGGn